8 8
********
*      *
*  *****
*      *
****  **
*  *   *
*  *** *
*       